########################################
#                                      #
#                                      #
#                                      #
#                                      #
#   #############     ############     #
#   #############     ############     #
#   ##                          ##     #
#   ##                          ##     #
#                                      #
#                                      #
#   ##                          ##     #
#   ##                          ##     #
#   #############     ############     #
#   #############     ############     #
#                                      #
#                                      #
#                                      #
#                                      #
########################################