########################################
#                                      #
#                 ###                  #
#########         ###                  #
#########         ###            ##    #
#                                ##    #
#                                ##    #
#     ####                       ##    #
#     #####                      ##    #
#     ######                           #
#     #######                          #
#                                      #
#                       ########       #
#       ######          ########       #
#       ######     #######             #
#           ##     #######       ####  #
#           ##          ##       ####  #
#                                ####  #
#                                      #
########################################